#######
O   # #
### # #
#   # #
# ### #
#     X
#######
